1111111111111111111111111
1P00000000000000000000001
1000CCC000000000000C00001
10000000E0000000000000001
1000CCC000000000000C00001
1000CCC000000000000C00001
1111111111111111111111111