1111111111111111111111111
10000000000C0000000000001
100ECCCCCCCCCC00000000001
1010101010101000101010101
1000000000000000000000001
1101010101010101010101011
11C1C1C1C1C1C1C1C1C1C1C11
1111111111111111111111111
